++++++++++
+00000000+
+00000000+
++++00000+
+00000++++
++++00000+
+00000++++
++++00000+
++++++++++